###########
# OO      #
######    #
#   ##    #
# P     ###
# X       #
# X       #
#   ##    #
###########