1111111111111111111111
1000000000000000000001
1000000000000000000001
1001111110000111111001
1001000010000100001001
1001000011111100001001
1001000000000000001001
1001000000000000001001
1000000000000000000001
1000111000000001110001
1000111000000001110001
1000111000000001110001
1000001110000111000001
1000001110000111000001
1000001110000111000001
1000000000000000000001
1000000000000000000001
1001110000000000111001
1001111111111111111001
1001110000000000111001
1000000000000000000001
1000000000000000000001
1111111111111111111111