1111111111111111111111
1000000000000000000001
1000000000000000000001
1001110010000100111001
1001110010000100111001
1001110010000100111001
1000000010000100000001
1000000010000100000001
1001111110000111111001
1001000000000000001001
1001000000000000001001
1001000000000000001001
1001011111001111101001
1000000000000000000001
1000000000000000000001
1111100011111100011111
1000000010000100000001
1000000010000100000001
1001110010000100111001
1001110010000100111001
1001110010000100111001
1000000000000000000001
1111111111111111111111