1111111111111111111111
1000000011111100000001
1000000000000000000001
1001111110000111111001
1000000000000000000001
1000000000110000000001
1001111100000011111001
1001000000000000001001
1001000000000000001001
1001001111001111001001
1001001000000001001001
1000001000000001000001
1001001000000001001001
1001001111001111001001
1001000000000000001001
1001000000000000001001
1001111100000011111001
1000000000110000000001
1000000000000000000001
1001111110000111111001
1000000000000000000001
1000000011111100000001
1111111111111111111111