16 16 16 11 16 16 16 04 16 16 07 16 16 16 05 16 05 16 16 16 16 16 16 16 16 16 16 16 16 16 16 16 16 16 16 16
16 05 16 16 16 16 16 16 16 16 16 16 16 16 16 16 16 16 05 16 16 16 16 16 16 16 16 16 07 16 16 16 16 16 16 16
16 16 16 16 16 07 16 16 16 16 06 16 16 16 16 16 16 16 13 16 16 16 16 16 16 16 16 16 16 16 16 16 09 16 16 10
16 16 08 16 16 16 16 16 09 16 16 16 16 16 16 16 16 16 16 16 16 16 16 16 16 16 16 16 16 16 16 16 16 16 16 16
16 16 16 06 16 16 16 16 16 10 16 16 16 16 16 16 16 16 16 16 16 16 16 16 16 16 16 16 16 08 16 16 06 16 16 16
04 16 16 16 05 16 16 16 16 16 16 16 16 16 16 16 16 16 16 16 16 16 16 16 13 16 16 16 16 16 16 16 16 16 16 16
16 16 09 16 16 16 16 16 16 16 16 09 16 16 16 16 16 16 16 16 16 16 16 16 16 16 16 16 09 16 16 16 16 16 16 16
16 16 16 16 16 16 11 16 05 16 16 16 16 16 16 16 16 16 16 16 16 16 16 16 16 16 16 16 16 16 06 16 16 16 16 16
16 16 16 16 16 16 16 16 16 16 16 16 16 16 16 16 16 16 16 16 16 16 16 16 16 16 16 16 16 16 16 16 16 04 07 16
16 16 16 16 05 16 16 16 16 16 16 16 16 16 16 16 16 16 16 16 16 16 16 13 16 16 16 16 16 16 16 16 16 16 16 16
16 16 16 16 16 16 16 16 16 16 16 16 16 16 16 16 16 16 16 16 16 16 16 16 16 16 16 15 16 16 16 16 16 16 16 16
16 16 16 16 13 16 16 16 16 16 16 16 16 16 16 16 16 16 16 16 16 16 16 14 16 16 16 16 16 16 16 16 16 16 16 16
16 16 16 16 16 16 16 16 16 16 16 16 16 16 16 13 16 16 16 16 16 16 16 16 16 16 16 16 16 16 16 16 16 16 16 16
16 16 16 16 16 16 16 16 16 16 16 16 16 16 16 16 16 16 16 16 16 16 16 16 16 16 16 16 16 16 16 16 16 16 16 16
16 16 16 16 16 16 16 16 16 16 16 16 16 16 16 16 16 16 16 16 16 16 16 09 16 16 16 16 16 16 16 16 07 16 16 16
16 16 16 16 16 13 16 16 16 07 16 16 16 16 15 16 16 16 16 16 16 16 16 16 16 16 16 16 16 05 16 16 16 16 16 16
16 16 16 16 16 16 16 16 16 16 16 16 16 16 16 16 16 16 16 11 16 16 16 16 16 16 16 16 16 16 16 16 16 13 16 16
16 16 16 16 16 16 16 16 16 16 16 16 16 16 16 16 16 16 16 16 16 16 16 16 16 16 16 16 16 16 16 16 16 16 16 16
16 16 08 16 16 16 11 16 10 16 16 16 05 16 16 16 16 16 16 08 16 16 16 11 16 08 16 16 16 05 16 16 16 16 16 16
16 16 16 16 16 04 16 16 16 16 16 16 16 16 16 16 16 16 16 16 16 16 04 16 16 16 05 16 16 16 16 16 16 16 16 16
16 06 16 16 16 16 16 16 07 16 16 16 16 16 16 04 16 16 06 16 16 16 16 16 16 07 16 16 16 16 16 16 04 16 05 16

26 26 26 26 26 26 26 26 26 26 26 26 26 26 26 26 26 26 26 26 26 26 26 26 26 26 26 26 26 26 26 26 26 26 26 26
26 26 26 26 26 26 26 26 26 26 26 26 26 26 26 26 26 26 26 26 26 26 26 26 26 26 26 26 26 26 26 26 26 26 26 26
26 26 26 26 26 26 26 26 26 26 26 26 08 05 05 05 05 05 05 05 05 05 05 05 05 05 09 26 26 26 26 26 26 26 26 26
26 26 26 26 26 26 26 26 26 26 26 26 07 27 27 27 27 27 27 27 27 27 27 27 27 27 03 26 26 26 26 26 26 26 26 26
26 26 26 26 26 26 26 26 26 26 26 26 07 27 00 01 01 01 01 01 01 01 01 01 02 27 03 26 26 26 26 26 26 26 26 26
26 26 26 26 26 26 26 26 26 26 26 26 07 27 03 26 26 26 26 26 26 26 26 26 07 27 03 26 26 26 26 26 26 26 26 26
26 26 26 26 26 26 26 26 26 26 26 26 07 27 04 05 05 05 05 05 05 09 26 26 07 27 03 26 26 26 26 26 26 26 26 26
26 26 26 26 26 26 26 26 26 26 26 26 07 27 27 27 27 27 27 27 27 03 26 26 07 27 03 26 26 26 26 26 26 26 26 26
26 26 26 26 26 26 26 26 26 26 26 26 10 01 01 01 01 01 01 02 27 03 26 26 07 27 03 26 26 26 26 26 26 26 26 26
26 26 26 26 26 08 05 05 05 05 05 05 05 05 09 26 26 26 26 07 27 03 26 26 07 27 03 26 26 26 26 26 26 26 26 26
26 26 26 26 26 07 27 27 27 27 27 27 27 27 03 26 26 26 26 07 27 03 26 26 07 27 04 05 05 05 05 05 05 05 05 05
26 26 26 26 26 07 27 00 01 01 01 01 02 27 03 26 26 26 26 07 27 03 26 26 07 27 27 27 27 27 27 27 27 27 27 27
26 26 26 26 26 07 27 03 26 26 26 26 07 27 03 26 26 26 26 07 27 03 26 26 10 01 01 01 01 01 01 01 01 01 01 01
26 26 26 26 26 07 27 03 26 26 26 26 07 27 04 05 05 05 05 06 27 03 26 26 26 26 26 26 26 26 26 26 26 26 26 26
05 05 05 05 05 06 27 03 26 26 26 26 07 27 27 27 27 27 27 27 27 03 26 26 26 26 26 26 26 26 26 26 26 26 26 26
27 27 27 27 27 27 27 03 26 26 26 26 10 01 01 01 01 01 01 01 01 11 26 26 26 26 26 26 26 26 26 26 26 26 26 26
01 01 01 01 01 01 01 11 26 26 26 26 26 26 26 26 26 26 26 26 26 26 26 26 26 26 26 26 26 26 26 26 26 26 26 26
26 26 26 26 26 26 26 26 26 26 26 26 26 26 26 26 26 26 26 26 26 26 26 26 26 26 26 26 26 26 26 26 26 26 26 26
26 26 26 26 26 26 26 26 26 26 26 26 26 26 26 26 26 26 26 26 26 26 26 26 26 26 26 26 26 26 26 26 26 26 26 26
26 26 26 26 26 26 26 26 26 26 26 26 26 26 26 26 26 26 26 26 26 26 26 26 26 26 26 26 26 26 26 26 26 26 26 26
26 26 26 26 26 26 26 26 26 26 26 26 26 26 26 26 26 26 26 26 26 26 26 26 26 26 26 26 26 26 26 26 26 26 26 26
26 26 26 26 26 26 26 26 26 26 26 26 26 26 26 26 26 26 26 26 26 26 26 26 26 26 26 26 26 26 26 26 26 26 26 26