#############
#           #
#      X    #
# O         #
#     O     #
# X         #
#    P      #
#   ##      #
#############